############################################
##                                 _______##
##        $                        |  !  |##
##                                 |  !  |##
#########################         ##########
##                                        ##
##                                        ##
##           ###############################
##    $                               $   ##
##                                        ##
###########################           ######
##                                        ##
##                                        ##
##             #############################
##     $                     $            ##
##                                        ##
################################          ##
##                                        ##
##                                        ##
############################################